District,Working LHWs,LHW Submitted Report This Month,Urban LHWs,Urban Pop Covered,Rural LHWs,Rural Pop Covered,District Population,Total Pop Covered
Badin,1054,1036,188,178938,848,810901,1908804,989839
Dadu,1105,1099,261,218825,838,740023,1644804,958848
Hyderabad,1030,1027,683,745823,344,375663,2621931,1121486
Sujawal,203,198,23,22984,175,171451,836941,194435
Jamshoro,464,461,101,105711,360,358102,1075807,463813
Tando Allahyar,525,519,4,3723,515,521292,614050,525015
Thatta,374,374,118,118046,256,249613,763756,367659
Matiari,441,437,105,118173,332,327294,830981,445467
Tando Muhammad Khan,399,395,21,20165,374,376901,508698,397066
Karachi West,659,655,465,524737,190,216343,3450458,741080
Karachi East,240,241,236,256304,5,5535,2002805,261839
Korangi,446,445,444,498572,0,0,2530224,498572
Karachi Central,443,435,381,412037,54,56545,2986773,468582
Karachi South,217,214,203,222611,11,11888,1816951,234499
Malir,654,647,196,211598,449,439535,1758965,651133
Jacobabad,600,578,169,134613,409,294064,925265,428677
Larkana,975,968,218,197391,750,602983,1593295,800374
Shikarpur,787,771,277,230504,494,453861,1368518,684365
Kamber,821,793,288,271222,505,470252,1438417,741474
Kashmore,496,491,193,170151,297,246985,852622,417136
Khairpur,1575,1529,127,113033,1402,1319552,2519813,1432585
Naushero Feroze,1317,1302,256,238657,1046,953574,1720942,1192231
Shaheed Benazirabad,1187,1187,174,187475,1012,1006004,1719019,1193479
Sukkur,1124,1053,171,150465,882,738259,1228126,888724
Ghotki,703,700,128,140446,572,555381,1783702,695827
Mirpurkhas,887,873,214,200881,659,615023,1571142,815904
Sanghar,1107,1107,290,294498,817,799827,2155419,1094325
Tharparkar,634,632,0,0,632,692523,1649661,692523
Umerkot,519,520,172,193458,348,386276,1155714,579734
Badin,1051,1041,188,178857,853,817290,1908804,996147
Dadu,1105,1096,260,217856,836,734535,1644804,952391
Hyderabad,1029,1009,673,735642,336,366547,2621931,1102189
Sujawal,203,203,23,22957,180,173891,836941,196848
Jamshoro,464,459,101,105340,358,356143,1075807,461483
Tando Allahyar,523,519,4,3898,515,516802,614050,520700
Thatta,374,373,118,117152,255,241775,763756,358927
Matiari,441,440,107,118946,333,326662,830981,445608
Tando Muhammad Khan,399,394,21,20175,373,375993,508698,396168
Karachi West,652,647,457,515458,190,215703,3450458,731161
Karachi East,238,238,234,253668,4,4377,2002805,258045
Korangi,445,445,444,501794,0,0,2530224,501794
Karachi Central,443,430,376,404266,54,56629,2986773,460895
Karachi South,217,209,198,215738,11,11819,1816951,227557
Malir,654,649,197,213582,450,441276,1758965,654858
Jacobabad,600,581,171,133920,410,295496,925265,429416
Larkana,975,967,217,196463,750,603867,1593295,800330
Shikarpur,785,778,281,234160,497,457611,1368518,691771
Kamber,821,790,285,268766,505,471759,1438417,740525
Kashmore,496,479,188,165627,290,241256,852622,406883
Khairpur,1575,1524,131,115990,1393,1309366,2519813,1425356
Naushero Feroze,1317,1296,251,233256,1045,949993,1720942,1183249
Shaheed Benazirabad,1186,1168,174,187606,993,996792,1719019,1184398
Sukkur,1122,1056,178,157080,878,733637,1228126,890717
Ghotki,702,703,128,140591,575,557773,1783702,698364
Mirpurkhas,886,866,206,193382,660,613422,1571142,806804
Sanghar,1107,1107,290,294226,817,800029,2155419,1094255
Tharparkar,634,632,0,0,631,690994,1649661,690994
Umerkot,518,519,172,192741,347,383151,1155714,575892
Badin,1051,1034,188,179201,846,810923,1908804,990124
Dadu,1103,1096,261,217010,835,730306,1644804,947316
Hyderabad,1028,1027,683,746368,344,375986,2621931,1122354
Sujawal,203,203,23,22714,180,173513,836941,196227
Jamshoro,464,458,101,105484,357,355033,1075807,460517
Tando Allahyar,523,520,4,3929,516,516976,614050,520905
Thatta,374,374,118,117440,256,242985,763756,360425
Matiari,441,440,107,119019,333,327623,830981,446642
Tando Muhammad Khan,398,389,21,20099,368,372423,508698,392522
Karachi West,647,582,425,483933,157,177556,3450458,661489
Karachi East,237,237,233,251476,4,4422,2002805,255898
Korangi,444,445,444,502580,0,0,2530224,502580
Karachi Central,441,425,371,398545,54,56792,2986773,455337
Karachi South,213,208,197,215517,11,11822,1816951,227339
Malir,653,646,197,214272,447,437392,1758965,651664
Jacobabad,599,551,166,130660,385,275400,925265,406060
Larkana,974,963,215,194613,748,604274,1593295,798887
Shikarpur,782,777,283,235616,494,454094,1368518,689710
Kamber,821,788,277,261396,511,479031,1438417,740427
Kashmore,495,465,186,164066,278,231016,852622,395082
Khairpur,1573,1521,122,108046,1399,1316266,2519813,1424312
Naushero Feroze,1317,1300,254,235945,1046,951723,1720942,1187668
Shaheed Benazirabad,1185,1183,173,186182,1009,1008984,1719019,1195166
Sukkur,1119,1084,232,204704,852,712328,1228126,917032
Ghotki,702,702,127,139523,575,557307,1783702,696830
Mirpurkhas,882,874,215,201174,659,611092,1571142,812266
Sanghar,1107,1106,290,293759,816,796574,2155419,1090333
Tharparkar,634,634,0,0,633,693269,1649661,693269
Umerkot,517,517,171,192763,346,382135,1155714,574898
Badin,1051,1034,187,178201,847,812189,1908804,990390
Dadu,1103,1095,262,218290,833,728247,1644804,946537
Hyderabad,1028,1019,678,740334,340,370829,2621931,1111163
Sujawal,202,192,22,21773,170,164604,836941,186377
Jamshoro,464,459,100,104173,359,357180,1075807,461353
Tando Allahyar,523,520,4,3923,516,517109,614050,521032
Thatta,373,372,117,117112,255,240287,763756,357399
Matiari,441,439,107,119244,332,327848,830981,447092
Tando Muhammad Khan,399,398,21,19832,377,382317,508698,402149
Karachi West,647,639,454,511010,185,209614,3450458,720624
Karachi East,237,236,233,252974,3,3297,2002805,256271
Korangi,444,445,444,503983,0,0,2530224,503983
Karachi Central,441,427,373,401432,54,56491,2986773,457923
Karachi South,212,209,198,216712,11,11691,1816951,228403
Malir,652,641,195,212592,445,434227,1758965,646819
Jacobabad,597,584,174,136997,410,296564,925265,433561
Larkana,973,967,220,199131,747,600871,1593295,800002
Shikarpur,782,683,247,204781,436,395255,1368518,600036
Kamber,821,802,287,270533,515,483978,1438417,754511
Kashmore,494,443,173,153602,269,224402,852622,378004
Khairpur,1570,1523,129,113402,1394,1310636,2519813,1424038
Naushero Feroze,1312,1296,253,234906,1043,950134,1720942,1185040
Shaheed Benazirabad,1184,1183,173,185850,1009,999529,1719019,1185379
Sukkur,1118,1074,232,203632,842,704510,1228126,908142
Ghotki,702,700,127,139509,573,555518,1783702,695027
Mirpurkhas,881,864,209,196225,655,606237,1571142,802462
Sanghar,1106,1105,289,292405,816,795773,2155419,1088178
Tharparkar,634,632,0,0,631,691373,1649661,691373
Umerkot,516,516,171,193170,345,381022,1155714,574192
Badin,1046,1033,186,177382,847,812563,1908804,989945
Dadu,1103,1093,261,217223,832,726398,1644804,943621
Hyderabad,1025,1016,674,736643,340,371978,2621931,1108621
Sujawal,202,196,22,21672,174,167634,836941,189306
Jamshoro,462,458,100,104280,358,356538,1075807,460818
Tando Allahyar,523,520,4,4179,516,517913,614050,522092
Thatta,373,366,115,115715,251,236655,763756,352370
Matiari,441,439,106,118834,333,328656,830981,447490
Tando Muhammad Khan,399,399,21,19865,378,382950,508698,402815
Karachi West,646,642,453,509428,189,214292,3450458,723720
Karachi East,236,235,233,251749,2,2245,2002805,253994
Korangi,441,442,441,500674,0,0,2530224,500674
Karachi Central,441,428,374,400477,54,56581,2986773,457058
Karachi South,212,210,199,216693,11,11707,1816951,228400
Malir,652,645,197,214099,446,434313,1758965,648412
Jacobabad,597,584,173,136797,411,296039,925265,432836
Larkana,973,964,213,193070,751,604168,1593295,797238
Shikarpur,781,779,284,236849,495,456021,1368518,692870
Kamber,821,785,275,259202,510,478006,1438417,737208
Kashmore,494,455,185,163229,269,223065,852622,386294
Khairpur,1570,1491,123,108267,1368,1287402,2519813,1395669
Naushero Feroze,1310,1287,250,232192,1037,945698,1720942,1177890
Shaheed Benazirabad,1184,1182,173,186123,1008,997701,1719019,1183824
Sukkur,1118,832,123,109214,709,588192,1228126,697406
Ghotki,701,699,127,139486,572,555689,1783702,695175
Mirpurkhas,881,859,208,194890,651,602546,1571142,797436
Sanghar,1106,1105,289,292850,816,796230,2155419,1089080
Tharparkar,634,632,0,0,631,692280,1649661,692280
Umerkot,516,516,170,192355,346,381851,1155714,574206
Badin,1046,1034,187,178337,847,813154,1908804,991491
Dadu,1103,1097,262,218175,835,730430,1644804,948605
Hyderabad,1026,1019,676,739050,341,372443,2621931,1111493
Sujawal,202,198,23,22673,175,169056,836941,191729
Jamshoro,462,456,100,104361,356,355124,1075807,459485
Tando Allahyar,522,520,4,4154,516,517002,614050,521156
Thatta,373,368,114,114752,254,239522,763756,354274
Matiari,440,440,106,118592,334,330024,830981,448616
Tando Muhammad Khan,398,399,21,19855,378,384082,508698,403937
Karachi West,646,641,453,509317,188,213301,3450458,722618
Karachi East,235,235,233,251672,2,2246,2002805,253918
Korangi,441,439,438,497609,0,0,2530224,497609
Karachi Central,441,426,372,398574,54,56516,2986773,455090
Karachi South,210,208,197,214631,11,11713,1816951,226344
Malir,652,646,196,212969,448,437718,1758965,650687
Jacobabad,597,580,172,136550,408,295226,925265,431776
Larkana,973,963,214,193638,749,602590,1593295,796228
Shikarpur,780,779,284,237272,495,457020,1368518,694292
Kamber,821,816,297,279491,519,487774,1438417,767265
Kashmore,494,477,188,165504,288,238455,852622,403959
Khairpur,1571,1509,124,109994,1385,1301913,2519813,1411907
Naushero Feroze,1309,1288,251,233482,1037,947480,1720942,1180962
Shaheed Benazirabad,1184,1184,173,186148,1010,995911,1719019,1182059
Sukkur,1118,944,162,145048,782,655756,1228126,800804
Ghotki,699,698,127,139718,571,554342,1783702,694060
Mirpurkhas,881,856,211,197746,645,597513,1571142,795259
Sanghar,1106,1105,289,292384,816,794707,2155419,1087091
Tharparkar,634,633,0,0,632,694296,1649661,694296
Umerkot,515,514,170,192408,344,379461,1155714,571869
Badin,1046,1033,186,178158,847,814441,1908804,992599
Dadu,1102,1097,261,217613,836,730859,1644804,948472
Hyderabad,1026,1018,675,737242,340,372624,2621931,1109866
Sujawal,202,201,23,22513,178,172395,836941,194908
Jamshoro,461,456,100,104229,356,355504,1075807,459733
Tando Allahyar,522,521,4,4184,517,517670,614050,521854
Thatta,373,362,113,113887,249,235032,763756,348919
Matiari,440,437,106,118573,331,328661,830981,447234
Tando Muhammad Khan,397,398,21,19873,377,384011,508698,403884
Karachi West,645,639,449,504473,190,214485,3450458,718958
Karachi East,233,227,226,245112,1,1081,2002805,246193
Korangi,439,423,422,479807,0,0,2530224,479807
Karachi Central,437,423,369,394397,54,56481,2986773,450878
Karachi South,211,208,197,214462,11,11721,1816951,226183
Malir,652,648,198,215599,448,438161,1758965,653760
Jacobabad,597,568,164,129879,404,292448,925265,422327
Larkana,973,967,220,199480,747,602908,1593295,802388
Shikarpur,780,772,282,235168,490,452457,1368518,687625
Kamber,820,791,284,266629,507,476500,1438417,743129
Kashmore,494,408,156,137988,251,206993,852622,344981
Khairpur,1570,1539,131,115189,1408,1324606,2519813,1439795
Naushero Feroze,1307,1281,249,232122,1031,940269,1720942,1172391
Shaheed Benazirabad,1183,1182,172,185122,1009,1022307,1719019,1207429
Sukkur,1118,703,115,102188,588,495586,1228126,597774
Ghotki,699,700,120,133260,580,564079,1783702,697339
Mirpurkhas,882,850,194,181994,656,607475,1571142,789469
Sanghar,1106,1104,289,292115,815,792705,2155419,1084820
Tharparkar,634,631,0,0,630,693277,1649661,693277
Umerkot,515,513,172,194732,340,376171,1155714,570903
Badin,1046,1030,186,177724,844,811998,1908804,989722
Dadu,1100,1092,262,218247,830,726044,1644804,944291
Hyderabad,1028,1022,676,739942,340,373079,2621931,1113021
Sujawal,202,199,22,21179,177,170731,836941,191910
Jamshoro,461,452,97,101314,355,356216,1075807,457530
Tando Allahyar,522,520,4,4209,516,517576,614050,521785
Thatta,373,362,114,115643,248,235583,763756,351226
Matiari,440,436,105,117589,331,330304,830981,447893
Tando Muhammad Khan,397,398,21,20074,377,386014,508698,406088
Karachi West,646,644,454,509642,190,214453,3450458,724095
Karachi East,232,228,227,244670,1,1082,2002805,245752
Korangi,439,433,432,490961,0,0,2530224,490961
Karachi Central,430,414,360,385269,54,56643,2986773,441912
Karachi South,209,208,197,213973,11,11738,1816951,225711
Malir,650,645,195,211880,448,436327,1758965,648207
Jacobabad,597,572,169,133724,403,292909,925265,426633
Larkana,971,970,220,199326,750,602794,1593295,802120
Shikarpur,780,765,282,234727,483,445041,1368518,679768
Kamber,816,787,281,264610,506,474415,1438417,739025
Kashmore,494,485,192,169042,292,242425,852622,411467
Khairpur,1569,1519,128,112384,1391,1308974,2519813,1421358
Naushero Feroze,1307,1285,251,233101,1033,943849,1720942,1176950
Shaheed Benazirabad,1184,1183,172,184708,1009,996577,1719019,1181285
Sukkur,1116,952,182,161134,770,645619,1228126,806753
Ghotki,699,699,118,131809,581,559546,1783702,691355
Mirpurkhas,881,853,206,194388,647,598921,1571142,793309
Sanghar,1105,1104,289,291818,815,792132,2155419,1083950
Tharparkar,634,630,0,0,629,690855,1649661,690855
Umerkot,511,512,172,195315,339,375888,1155714,571203
Badin,1045,1005,186,178820,819,784616,1908804,963436
Dadu,1100,1088,262,218546,826,723619,1644804,942165
Hyderabad,1023,982,644,706280,335,368617,2621931,1074897
Sujawal,202,199,22,21263,177,170393,836941,191656
Jamshoro,461,456,99,101693,357,354994,1075807,456687
Tando Allahyar,522,521,4,4081,517,517676,614050,521757
Thatta,373,355,114,116064,241,227696,763756,343760
Matiari,440,439,106,118776,333,331538,830981,450314
Tando Muhammad Khan,397,397,20,19114,377,391384,508698,410498
Karachi West,646,626,440,492438,186,211149,3450458,703587
Karachi East,230,225,225,243108,0,0,2002805,243108
Korangi,434,433,432,489303,0,0,2530224,489303
Karachi Central,429,429,376,401387,53,55633,2986773,457020
Karachi South,209,195,184,198960,11,11733,1816951,210693
Malir,649,646,196,211613,448,435911,1758965,647524
Jacobabad,597,558,167,127750,391,273436,925265,401186
Larkana,971,967,220,199249,747,599299,1593295,798548
Shikarpur,780,764,276,229384,488,447736,1368518,677120
Kamber,815,783,278,262185,505,471998,1438417,734183
Kashmore,494,431,165,145548,265,219116,852622,364664
Khairpur,1569,1509,126,111001,1383,1300856,2519813,1411857
Naushero Feroze,1307,1280,248,231401,1031,942469,1720942,1173870
Shaheed Benazirabad,1183,1183,172,184998,1008,1005631,1719019,1190629
Sukkur,1116,879,137,122452,742,626605,1228126,749057
Ghotki,699,699,118,130442,581,556999,1783702,687441
Mirpurkhas,881,849,206,193597,643,594496,1571142,788093
Sanghar,1104,1102,287,290397,815,790356,2155419,1080753
Tharparkar,634,630,0,0,629,686089,1649661,686089
Umerkot,509,508,172,194928,335,371565,1155714,566493
Badin,1044,1000,181,176047,819,784298,1908804,960345
Dadu,1100,1091,258,215141,833,729013,1644804,944154
Hyderabad,1022,1008,666,728946,339,372378,2621931,1101324
Sujawal,202,201,23,22330,178,167110,836941,189440
Jamshoro,460,455,100,103214,355,353823,1075807,457037
Tando Allahyar,522,520,4,4146,516,516464,614050,520610
Thatta,373,347,110,109662,237,223790,763756,333452
Matiari,439,439,106,118907,333,331851,830981,450758
Tando Muhammad Khan,397,397,20,19448,377,395453,508698,414901
Karachi West,646,616,432,487042,184,208015,3450458,695057
Karachi East,229,225,225,242621,0,0,2002805,242621
Korangi,433,432,431,488067,0,0,2530224,488067
Karachi Central,426,410,357,381716,53,55354,2986773,437070
Karachi South,209,202,193,210804,9,9401,1816951,220205
Malir,648,615,192,207531,421,408617,1758965,616148
Jacobabad,597,566,169,131141,397,272588,925265,403729
Larkana,971,968,220,198160,748,600411,1593295,798571
Shikarpur,780,775,283,235226,492,452257,1368518,687483
Kamber,815,750,254,240165,496,464681,1438417,704846
Kashmore,494,475,188,165569,286,237064,852622,402633
Khairpur,1568,1486,125,110213,1361,1281675,2519813,1391888
Naushero Feroze,1306,1283,247,229744,1035,946880,1720942,1176624
Shaheed Benazirabad,1183,1183,172,182852,1008,994558,1719019,1177410
Sukkur,1116,893,159,141896,734,613581,1228126,755477
Ghotki,699,699,118,130323,581,555345,1783702,685668
Mirpurkhas,881,842,203,190131,639,589655,1571142,779786
Sanghar,1101,1101,286,289576,815,788955,2155419,1078531
Tharparkar,634,632,0,0,631,687856,1649661,687856
Umerkot,509,503,166,188307,337,373044,1155714,561351
Badin,1042,1002,182,177275,820,787547,1908804,964822
Dadu,1100,1094,261,218422,833,727842,1644804,946264
Hyderabad,1022,1009,667,728775,340,373852,2621931,1102627
Sujawal,202,198,23,22296,175,162922,836941,185218
Jamshoro,459,454,99,102088,355,353557,1075807,455645
Tando Allahyar,522,520,4,4168,516,516728,614050,520896
Thatta,373,359,113,113369,246,232254,763756,345623
Matiari,439,437,106,119104,331,330630,830981,449734
Tando Muhammad Khan,397,397,20,19542,377,396804,508698,416346
Karachi West,646,606,425,477765,181,204346,3450458,682111
Karachi East,229,228,228,246060,0,0,2002805,246060
Korangi,433,431,430,487136,0,0,2530224,487136
Karachi Central,423,398,345,370989,53,55413,2986773,426402
Karachi South,209,201,193,211523,8,8493,1816951,220016
Malir,648,628,192,207822,434,421310,1758965,629132
Jacobabad,597,569,172,131576,397,272659,925265,404235
Larkana,969,969,220,198285,749,600387,1593295,798672
Shikarpur,780,762,271,225723,491,451763,1368518,677486
Kamber,815,778,280,264496,498,463716,1438417,728212
Kashmore,494,450,180,158279,269,222517,852622,380796
Khairpur,1566,1513,127,112034,1386,1304088,2519813,1416122
Naushero Feroze,1306,1283,247,230309,1035,949293,1720942,1179602
Shaheed Benazirabad,1183,1183,172,182630,1008,995322,1719019,1177952
Sukkur,1116,858,169,151132,689,592499,1228126,743631
Ghotki,699,699,118,130023,581,555617,1783702,685640
Mirpurkhas,881,818,208,195392,610,561694,1571142,757086
Sanghar,1101,1101,286,289245,815,788791,2155419,1078036
Tharparkar,633,631,0,0,630,688056,1649661,688056
Umerkot,509,512,172,195385,339,375274,1155714,570659
Badin,1042,1024,185,179851,839,808191,1908804,988042
Dadu,1099,1091,260,218242,831,726657,1644804,944899
Hyderabad,1022,1011,665,727764,340,374355,2621931,1102119
Sujawal,202,202,23,22122,179,167501,836941,189623
Jamshoro,459,452,98,100991,354,354071,1075807,455062
Tando Allahyar,522,521,4,4188,517,518248,614050,522436
Thatta,373,366,114,114959,252,237505,763756,352464
Matiari,439,434,104,116261,330,329427,830981,445688
Tando Muhammad Khan,396,396,20,19519,376,397662,508698,417181
Karachi West,646,597,442,494894,155,171578,3450458,666472
Karachi East,229,228,228,246252,0,0,2002805,246252
Korangi,430,429,428,483975,0,0,2530224,483975
Karachi Central,423,405,352,376866,53,55142,2986773,432008
Karachi South,208,204,194,213017,10,10596,1816951,223613
Malir,648,637,193,209188,442,430877,1758965,640065
Jacobabad,597,562,166,128254,396,272709,925265,400963
Larkana,969,965,220,198372,745,598378,1593295,796750
Shikarpur,779,741,257,214336,484,446868,1368518,661204
Kamber,815,782,279,261948,503,468854,1438417,730802
Kashmore,494,462,181,159119,280,232021,852622,391140
Khairpur,1566,1448,104,91446,1344,1262895,2519813,1354341
Naushero Feroze,1306,1286,246,229717,1039,953450,1720942,1183167
Shaheed Benazirabad,1182,1183,172,183125,1008,1005228,1719019,1188353
Sukkur,1116,936,148,132665,788,666542,1228126,799207
Ghotki,699,699,118,130498,581,556056,1783702,686554
Mirpurkhas,881,841,204,191834,637,596454,1571142,788288
Sanghar,1101,1100,286,289006,814,789211,2155419,1078217
Tharparkar,633,633,0,0,632,690802,1649661,690802
Umerkot,509,512,172,195157,339,376367,1155714,571524
Badin,1040,1028,187,204057,841,839731,1908804,1043788
Dadu,1099,1093,262,237018,831,769665,1644804,1006683
Hyderabad,1010,1001,657,718245,338,371956,2621931,1090201
Sujawal,202,201,23,22141,178,166800,836941,188941
Jamshoro,457,455,101,104652,354,353807,1075807,458459
Tando Allahyar,521,519,4,4190,515,516654,614050,520844
Thatta,371,360,113,120756,247,249430,763756,370186
Matiari,438,435,104,118487,331,355343,830981,473830
Tando Muhammad Khan,396,396,20,19710,376,397771,508698,417481
Karachi West,646,623,441,494143,182,204576,3450458,698719
Karachi East,228,227,227,249231,0,0,2002805,249231
Korangi,427,430,429,480751,0,0,2530224,480751
Karachi Central,412,403,352,377413,51,53042,2986773,430455
Karachi South,207,207,196,216595,11,11665,1816951,228260
Malir,645,639,193,208622,444,430921,1758965,639543
Jacobabad,597,576,169,132122,407,281269,925265,413391
Larkana,968,967,220,197977,747,599836,1593295,797813
Shikarpur,778,772,280,233755,492,468485,1368518,702240
Kamber,813,797,286,270005,511,474788,1438417,744793
Kashmore,493,484,190,167152,293,243346,852622,410498
Khairpur,1565,1524,128,112948,1396,1313140,2519813,1426088
Naushero Feroze,1301,1278,245,228926,1032,946870,1720942,1175796
Shaheed Benazirabad,1179,1179,172,183122,1004,993508,1719019,1176630
Sukkur,1114,1010,174,157024,836,704898,1228126,861922
Ghotki,696,696,115,127148,581,554961,1783702,682109
Mirpurkhas,878,864,214,200084,650,601993,1571142,802077
Sanghar,1100,1097,286,289590,811,785958,2155419,1075548
Tharparkar,633,633,0,0,632,694372,1649661,694372
Umerkot,509,505,169,191165,335,368192,1155714,559357
Badin,1039,1024,186,204419,838,841178,1908804,1045597
Dadu,1099,1090,262,276947,828,806354,1644804,1083301
Hyderabad,1010,1004,662,723644,336,370828,2621931,1094472
Sujawal,202,199,23,22166,176,165150,836941,187316
Jamshoro,457,454,101,107968,353,359505,1075807,467473
Tando Allahyar,521,516,4,4179,512,519948,614050,524127
Thatta,371,365,116,131034,249,256181,763756,387215
Matiari,438,433,102,116047,331,356767,830981,472814
Tando Muhammad Khan,395,395,19,18777,376,400575,508698,419352
Karachi West,630,621,439,490613,182,204818,3450458,695431
Karachi East,228,228,228,256467,0,0,2002805,256467
Korangi,428,428,427,482042,0,0,2530224,482042
Karachi Central,408,390,339,362542,51,53241,2986773,415783
Karachi South,207,207,196,217099,11,11721,1816951,228820
Malir,644,638,192,209083,444,432587,1758965,641670
Jacobabad,597,569,170,132170,399,276162,925265,408332
Larkana,968,964,216,194353,748,602643,1593295,796996
Shikarpur,776,768,279,232865,489,466712,1368518,699577
Kamber,813,687,238,227839,449,416058,1438417,643897
Kashmore,493,453,182,159608,270,223484,852622,383092
Khairpur,1560,1490,122,107128,1368,1284257,2519813,1391385
Naushero Feroze,1301,1279,248,230554,1030,944260,1720942,1174814
Shaheed Benazirabad,1179,1140,172,183754,965,962337,1719019,1146091
Sukkur,1111,1006,172,155132,834,706671,1228126,861803
Ghotki,696,696,115,127210,581,555463,1783702,682673
Mirpurkhas,878,866,214,202338,652,606221,1571142,808559
Sanghar,1100,1094,285,288446,809,786345,2155419,1074791
Tharparkar,631,631,0,0,630,692716,1649661,692716
Umerkot,509,506,167,188792,338,366542,1155714,555334
Badin,1039,1025,186,203920,839,844949,1908804,1048869
Dadu,1098,1074,258,274940,816,800658,1644804,1075598
Hyderabad,1008,988,651,710993,334,375854,2621931,1086847
Sujawal,202,189,20,19915,169,158410,836941,178325
Jamshoro,457,438,101,112205,337,344979,1075807,457184
Tando Allahyar,522,516,4,4200,512,525838,614050,530038
Thatta,371,368,117,133105,251,258000,763756,391105
Matiari,438,431,103,117713,328,354349,830981,472062
Tando Muhammad Khan,395,395,19,18795,376,401431,508698,420226
Karachi West,630,574,411,463155,163,184291,3450458,647446
Karachi East,231,220,220,249745,0,0,2002805,249745
Korangi,428,428,427,481568,0,0,2530224,481568
Karachi Central,408,401,350,373935,51,52975,2986773,426910
Karachi South,207,206,195,215840,11,11573,1816951,227413
Malir,644,639,192,209750,445,433873,1758965,643623
Jacobabad,596,578,172,141158,406,281551,925265,422709
Larkana,968,961,214,193489,747,601192,1593295,794681
Shikarpur,775,765,279,233178,486,465600,1368518,698778
Kamber,811,664,218,207063,446,421215,1438417,628278
Kashmore,493,435,164,143109,270,223155,852622,366264
Khairpur,1560,1484,126,111004,1358,1277676,2519813,1388680
Naushero Feroze,1299,1275,249,232420,1025,940694,1720942,1173114
Shaheed Benazirabad,1179,1179,172,183027,1004,1004959,1719019,1187986
Sukkur,1111,1041,206,183095,835,708582,1228126,891677
Ghotki,696,696,115,127584,581,556015,1783702,683599
Mirpurkhas,877,866,210,201673,656,612199,1571142,813872
Sanghar,1098,1097,286,289077,811,788703,2155419,1077780
Tharparkar,631,631,0,0,630,692823,1649661,692823
Umerkot,508,505,169,191798,335,362824,1155714,554622
Badin,1039,1025,186,204751,839,845403,1908804,1050154
Dadu,1096,1087,261,278348,826,812725,1644804,1091073
Hyderabad,1006,995,656,716649,334,368033,2621931,1084682
Sujawal,202,196,22,21678,174,163680,836941,185358
Jamshoro,457,451,101,112402,350,359486,1075807,471888
Tando Allahyar,522,513,4,4199,509,514920,614050,519119
Thatta,371,363,114,130619,249,255964,763756,386583
Matiari,438,429,103,117635,326,352541,830981,470176
Tando Muhammad Khan,395,395,19,18761,376,402012,508698,420773
Karachi West,629,620,439,490032,181,203493,3450458,693525
Karachi East,231,220,220,250655,0,0,2002805,250655
Korangi,427,427,426,479678,0,0,2530224,479678
Karachi Central,405,395,344,367279,51,52709,2986773,419988
Karachi South,207,204,193,213945,11,11725,1816951,225670
Malir,644,636,191,209368,443,432320,1758965,641688
Jacobabad,596,558,168,137952,390,268736,925265,406688
Larkana,968,955,211,189621,744,597573,1593295,787194
Shikarpur,774,758,280,233928,478,456237,1368518,690165
Kamber,811,743,252,236214,491,462807,1438417,699021
Kashmore,493,483,190,167078,292,242430,852622,409508
Khairpur,1560,1202,116,103729,1086,1034110,2519813,1137839
Naushero Feroze,1299,1286,249,232281,1036,950643,1720942,1182924
Shaheed Benazirabad,1176,1176,171,182524,1002,1002236,1719019,1184760
Sukkur,1108,975,222,195991,753,641617,1228126,837608
Ghotki,695,695,115,127720,580,556370,1783702,684090
Mirpurkhas,876,856,206,198623,649,605835,1571142,804458
Sanghar,1097,1087,281,284134,806,784438,2155419,1068572
Tharparkar,631,631,0,0,630,693231,1649661,693231
Umerkot,508,505,168,190918,336,364088,1155714,555006
Badin,1038,1024,183,201177,841,849170,1908804,1050347
Dadu,1096,1091,261,279041,830,817126,1644804,1096167
Hyderabad,1006,990,653,714167,335,369805,2621931,1083972
Sujawal,202,196,22,21689,174,163747,836941,185436
Jamshoro,457,430,101,112280,329,338581,1075807,450861
Tando Allahyar,521,516,4,4203,512,519221,614050,523424
Thatta,371,360,114,130798,246,253501,763756,384299
Matiari,438,428,103,117802,325,352068,830981,469870
Tando Muhammad Khan,395,395,19,18786,376,402662,508698,421448
Karachi West,629,618,436,487505,182,204371,3450458,691876
Karachi East,231,229,229,260517,0,0,2002805,260517
Korangi,427,426,425,478193,0,0,2530224,478193
Karachi Central,403,391,340,362158,51,52801,2986773,414959
Karachi South,207,206,195,216177,11,11719,1816951,227896
Malir,644,637,191,209067,444,433904,1758965,642971
Jacobabad,595,563,167,129354,396,275121,925265,404475
Larkana,964,960,217,195601,743,596268,1593295,791869
Shikarpur,774,762,279,233177,483,461649,1368518,694826
Kamber,811,616,190,178405,426,395938,1438417,574343
Kashmore,493,474,183,160479,290,240501,852622,400980
Khairpur,1560,1205,103,90559,1102,1039077,2519813,1129636
Naushero Feroze,1299,1285,248,232212,1036,951510,1720942,1183722
Shaheed Benazirabad,1175,1175,171,182622,1001,992375,1719019,1174997
Sukkur,1105,880,163,144865,717,607201,1228126,752066
Ghotki,694,695,115,128329,580,556797,1783702,685126
Mirpurkhas,874,847,200,194018,647,604585,1571142,798603
Sanghar,1096,1096,285,288835,811,788450,2155419,1077285
Tharparkar,631,631,0,0,630,693215,1649661,693215
Umerkot,507,503,167,190691,335,362595,1155714,553286
Badin,1035,1024,185,204160,839,849242,1908804,1053402
Dadu,1096,1088,261,279258,827,816005,1644804,1095263
Hyderabad,1005,292,170,181852,120,132544,2621931,314396
Sujawal,202,197,22,21526,175,164807,836941,186333
Jamshoro,456,451,101,114182,350,363146,1075807,477328
Tando Allahyar,520,519,4,4624,515,562867,614050,567491
Thatta,371,347,113,129797,234,240064,763756,369861
Matiari,438,426,103,117022,323,350755,830981,467777
Tando Muhammad Khan,395,395,19,19247,376,402757,508698,422004
Karachi West,629,577,396,441531,181,202459,3450458,643990
Karachi East,230,225,225,257355,0,0,2002805,257355
Korangi,426,426,425,478049,0,0,2530224,478049
Karachi Central,401,388,338,360111,50,51817,2986773,411928
Karachi South,207,202,191,210673,11,11702,1816951,222375
Malir,644,637,192,210767,443,432967,1758965,643734
Jacobabad,595,553,166,128378,387,266651,925265,395029
Larkana,964,957,214,193657,743,594899,1593295,788556
Shikarpur,773,761,280,234312,481,460319,1368518,694631
Kamber,811,757,266,251249,491,463107,1438417,714356
Kashmore,493,426,172,151797,253,209262,852622,361059
Khairpur,1558,1492,127,111876,1365,1283040,2519813,1394916
Naushero Feroze,1299,1282,245,228651,1036,953274,1720942,1181925
Shaheed Benazirabad,1175,1175,171,182582,1001,993981,1719019,1176563
Sukkur,1103,964,166,148848,798,675532,1228126,824380
Ghotki,694,694,115,129402,579,559039,1783702,688441
Mirpurkhas,874,858,205,199634,652,610841,1571142,810475
Sanghar,1095,1093,284,287712,809,786206,2155419,1073918
Tharparkar,631,629,0,0,628,694046,1649661,694046
Umerkot,507,503,167,190025,335,362176,1155714,552201
Badin,1033,1022,184,201399,838,850196,1908804,1051595
Dadu,1096,1089,260,277961,829,819798,1644804,1097759
Hyderabad,1003,942,621,681679,316,348654,2621931,1030333
Sujawal,202,197,23,22532,174,163812,836941,186344
Jamshoro,455,451,100,114175,351,369612,1075807,483787
Tando Allahyar,520,507,4,4684,503,552694,614050,557378
Thatta,371,339,111,127162,228,233183,763756,360345
Matiari,438,408,103,116968,305,332459,830981,449427
Tando Muhammad Khan,393,394,19,19319,375,402398,508698,421717
Karachi West,629,539,363,406282,176,196969,3450458,603251
Karachi East,230,229,229,266552,0,0,2002805,266552
Korangi,425,425,424,476673,0,0,2530224,476673
Karachi Central,401,374,325,347474,49,50737,2986773,398211
Karachi South,207,204,193,214461,11,11708,1816951,226169
Malir,644,633,188,206883,443,430841,1758965,637724
Jacobabad,594,518,156,120968,362,250084,925265,371052
Larkana,964,955,211,191964,744,601007,1593295,792971
Shikarpur,772,767,280,234530,487,467560,1368518,702090
Kamber,810,764,270,257838,494,458618,1438417,716456
Kashmore,493,415,166,145055,248,204049,852622,349104
Khairpur,1558,1447,120,105825,1327,1253071,2519813,1358896
Naushero Feroze,1299,1275,242,225925,1032,951485,1720942,1177410
Shaheed Benazirabad,1169,1169,169,181135,997,990516,1719019,1171651
Sukkur,1103,950,170,152796,780,657516,1228126,810312
Ghotki,694,694,115,129799,579,560057,1783702,689856
Mirpurkhas,874,852,206,207653,646,653628,1571142,861281
Sanghar,1095,1089,282,286149,807,785361,2155419,1071510
Tharparkar,631,626,0,0,625,691681,1649661,691681
Umerkot,507,503,168,190690,334,361436,1155714,552126
Badin,1033,1017,183,200377,834,846381,1908804,1046758
Dadu,1095,1083,258,275715,825,818383,1644804,1094098
Hyderabad,1000,911,607,666374,300,332804,2621931,999178
Sujawal,202,196,23,22578,173,163410,836941,185988
Jamshoro,455,451,100,113512,351,372040,1075807,485552
Tando Allahyar,520,508,4,4680,504,555903,614050,560583
Thatta,371,357,113,129958,244,253295,763756,383253
Matiari,438,422,103,117141,319,347160,830981,464301
Tando Muhammad Khan,393,393,19,19342,374,402880,508698,422222
Karachi West,629,557,387,436379,170,192795,3450458,629174
Karachi East,230,228,228,270022,0,0,2002805,270022
Korangi,425,425,424,476157,0,0,2530224,476157
Karachi Central,399,382,332,355326,50,51740,2986773,407066
Karachi South,207,204,193,214885,11,11738,1816951,226623
Malir,644,627,187,206493,438,427517,1758965,634010
Jacobabad,592,555,164,126529,391,271405,925265,397934
Larkana,964,927,214,194801,713,578393,1593295,773194
Shikarpur,771,750,268,233119,482,463474,1368518,696593
Kamber,809,752,271,265763,481,447254,1438417,713017
Kashmore,493,473,193,169696,279,232239,852622,401935
Khairpur,1558,1440,123,109067,1317,1246127,2519813,1355194
Naushero Feroze,1299,1279,249,232808,1029,948852,1720942,1181660
Shaheed Benazirabad,1169,1169,169,181095,997,991787,1719019,1172882
Sukkur,1101,871,168,151377,703,599076,1228126,750453
Ghotki,693,694,115,129899,579,562485,1783702,692384
Mirpurkhas,872,836,207,213082,628,642077,1571142,855159
Sanghar,1093,1083,282,286419,801,780150,2155419,1066569
Tharparkar,631,628,0,0,627,693940,1649661,693940
Umerkot,506,502,167,189548,334,361755,1155714,551303
Badin,1031,1019,185,203764,834,851458,1908804,1055222
Dadu,1094,1088,261,278809,827,821979,1644804,1100788
Hyderabad,999,971,635,696439,332,367939,2621931,1064378
Sujawal,202,196,22,21602,174,164279,836941,185881
Jamshoro,454,449,99,114299,350,374513,1075807,488812
Tando Allahyar,520,505,4,4821,501,553999,614050,558820
Thatta,371,324,104,119192,220,225699,763756,344891
Matiari,438,425,101,115442,324,352592,830981,468034
Tando Muhammad Khan,393,393,19,19381,374,403667,508698,423048
Karachi West,629,551,381,429471,170,192733,3450458,622204
Karachi East,229,229,229,340509,0,0,2002805,340509
Korangi,424,424,423,475069,0,0,2530224,475069
Karachi Central,399,355,305,327320,50,51911,2986773,379231
Karachi South,207,205,194,216488,11,11761,1816951,228249
Malir,643,632,188,207811,442,433124,1758965,640935
Jacobabad,592,528,164,127496,364,249579,925265,377075
Larkana,964,935,207,221371,728,695763,1593295,917134
Shikarpur,771,728,256,224669,472,454804,1368518,679473
Kamber,808,742,269,283469,473,499681,1438417,783150
Kashmore,493,453,181,159156,271,223964,852622,383120
Khairpur,1558,1457,104,91771,1353,1275125,2519813,1366896
Naushero Feroze,1299,1275,247,230586,1027,948356,1720942,1178942
Shaheed Benazirabad,1169,1169,169,181171,997,992814,1719019,1173985
Sukkur,1100,926,165,148096,761,645606,1228126,793702
Ghotki,693,693,115,131081,578,563333,1783702,694414
Mirpurkhas,864,844,198,208134,645,678487,1571142,886621
Sanghar,1093,1081,281,285442,800,788233,2155419,1073675
Tharparkar,631,630,0,0,629,696470,1649661,696470
Umerkot,505,499,166,190087,332,362740,1155714,552827
Badin,1031,1022,185,204028,837,863148,1908804,1067176
Dadu,1092,1080,259,277411,821,819387,1644804,1096798
Hyderabad,996,962,628,690007,329,365534,2621931,1055541
Sujawal,202,195,23,22627,172,162772,836941,185399
Jamshoro,454,449,99,114479,350,374319,1075807,488798
Tando Allahyar,520,512,4,4911,508,568669,614050,573580
Thatta,371,314,98,116451,216,222473,763756,338924
Matiari,438,404,102,117012,302,328023,830981,445035
Tando Muhammad Khan,392,391,19,19405,372,402635,508698,422040
Karachi West,628,593,413,500459,180,219861,3450458,720320
Karachi East,228,226,226,346051,0,0,2002805,346051
Korangi,424,423,422,474424,0,0,2530224,474424
Karachi Central,396,368,319,342088,49,50719,2986773,392807
Karachi South,206,205,194,215154,11,11732,1816951,226886
Malir,642,530,139,153587,391,384009,1758965,537596
Jacobabad,592,503,161,125280,342,233504,925265,358784
Larkana,964,918,216,235477,702,694814,1593295,930291
Shikarpur,769,734,263,231118,471,454026,1368518,685144
Kamber,808,762,272,286172,490,519148,1438417,805320
Kashmore,493,447,183,160615,263,218067,852622,378682
Khairpur,1557,1342,122,108270,1220,1156765,2519813,1265035
Naushero Feroze,1299,1283,249,233847,1033,956452,1720942,1190299
Shaheed Benazirabad,1169,1168,169,181262,996,993234,1719019,1174496
Sukkur,1099,817,183,161037,634,536085,1228126,697122
Ghotki,693,693,115,131287,578,563819,1783702,695106
Mirpurkhas,863,841,202,217428,639,712844,1571142,930272
Sanghar,1093,1078,277,289791,801,806690,2155419,1096481
Tharparkar,631,628,0,0,627,694195,1649661,694195
Umerkot,505,500,167,204018,332,393805,1155714,597823
Badin,1031,1016,184,203605,832,892075,1908804,1095680
Dadu,1091,1088,262,291253,826,842801,1644804,1134054
Hyderabad,991,946,628,690881,314,350818,2621931,1041699
Sujawal,202,199,23,22697,176,167490,836941,190187
Jamshoro,454,444,97,112345,347,504985,1075807,617330
Tando Allahyar,520,504,4,4933,500,561682,614050,566615
Thatta,370,371,117,140499,254,264809,763756,405308
Matiari,438,432,102,117134,330,360126,830981,477260
Tando Muhammad Khan,391,392,19,19459,373,404684,508698,424143
Karachi West,630,540,375,464693,163,202490,3450458,667183
Karachi East,227,227,227,350901,0,0,2002805,350901
Korangi,422,406,405,465081,0,0,2530224,465081
Karachi Central,396,367,318,337232,49,50875,2986773,388107
Karachi South,203,201,191,212838,10,10678,1816951,223516
Malir,642,573,184,206054,387,390393,1758965,596447
Jacobabad,592,508,158,122121,350,242701,925265,364822
Larkana,964,889,194,231413,695,824918,1593295,1056331
Shikarpur,768,734,266,234104,468,450812,1368518,684916
Kamber,808,718,246,267856,472,498834,1438417,766690
Kashmore,493,441,176,155071,264,218642,852622,373713
Khairpur,1557,1387,92,84275,1295,1217416,2519813,1301691
Naushero Feroze,1299,1278,246,231308,1031,956848,1720942,1188156
Shaheed Benazirabad,1169,1169,169,180922,997,993371,1719019,1174293
Sukkur,1098,839,178,158997,661,565645,1228126,724642
Ghotki,693,693,115,131506,578,564301,1783702,695807
Mirpurkhas,862,809,195,209705,613,709812,1571142,919517
Sanghar,1089,1072,276,307895,796,845716,2155419,1153611
Tharparkar,630,626,0,0,625,693273,1649661,693273
Umerkot,504,498,163,201298,334,408960,1155714,610258
Badin,1031,1027,185,204091,842,902396,1908804,1106487
Dadu,1090,1088,262,290935,826,855549,1644804,1146484
Hyderabad,989,961,626,692342,331,368579,2621931,1060921
Sujawal,199,199,23,23221,176,168383,836941,191604
Jamshoro,453,449,98,113839,351,375832,1075807,489671
Tando Allahyar,520,503,4,4955,499,562407,614050,567362
Thatta,370,341,115,140190,226,252477,763756,392667
Matiari,432,432,102,127575,330,378667,830981,506242
Tando Muhammad Khan,391,391,19,19520,372,402823,508698,422343
Karachi West,630,481,331,418791,148,185768,3450458,604559
Karachi East,227,225,225,345641,0,0,2002805,345641
Korangi,421,417,416,476371,0,0,2530224,476371
Karachi Central,394,388,338,371584,50,51942,2986773,423526
Karachi South,203,182,172,191015,10,10679,1816951,201694
Malir,640,619,187,210569,430,427090,1758965,637659
Jacobabad,590,498,153,117666,345,238419,925265,356085
Larkana,955,925,203,225534,722,757935,1593295,983469
Shikarpur,768,723,258,226753,465,449372,1368518,676125
Kamber,805,783,280,293181,503,543105,1438417,836286
Kashmore,493,409,162,143094,247,205938,852622,349032
Khairpur,1557,1400,123,108817,1277,1205439,2519813,1314256
Naushero Feroze,1298,1019,194,181907,824,767148,1720942,949055
Shaheed Benazirabad,1169,1103,169,180715,931,935447,1719019,1116162
Sukkur,1097,1016,230,205783,786,672860,1228126,878643
Ghotki,693,693,115,131650,578,565286,1783702,696936
Mirpurkhas,861,779,160,173083,618,721767,1571142,894850
Sanghar,1088,1073,278,313815,795,862451,2155419,1176266
Tharparkar,631,629,0,0,628,697575,1649661,697575
Umerkot,504,494,161,201355,332,413264,1155714,614619
Badin,1065,1046,190,187297,856,804575,1908804,991872
Dadu,1112,1104,265,225238,839,743162,1644804,968400
Hyderabad,1051,1026,679,740260,347,375734,2621931,1115994
Sujawal,204,204,23,22774,181,177164,836941,199938
Jamshoro,482,475,107,112326,368,365082,1075807,477408
Tando Allahyar,529,525,4,3754,521,526055,614050,529809
Thatta,378,377,120,121043,257,241461,763756,362504
Matiari,448,444,110,121870,334,328119,830981,449989
Tando Muhammad Khan,404,402,21,20238,381,380246,508698,400484
Karachi West,678,671,478,542897,193,222845,3450458,765742
Karachi East,254,254,246,265282,8,8890,2002805,274172
Korangi,460,457,457,489857,0,0,2530224,489857
Karachi Central,465,459,402,438872,57,62160,2986773,501032
Karachi South,222,218,206,229954,12,13125,1816951,243079
Malir,682,660,206,219293,454,440642,1758965,659935
Jacobabad,605,601,176,139919,425,305973,925265,445892
Larkana,983,980,222,199327,758,609285,1593295,808612
Shikarpur,803,796,291,240748,505,455265,1368518,696013
Kamber,824,525,129,118935,396,369589,1438417,488524
Kashmore,496,477,188,165839,288,239701,852622,405540
Khairpur,1590,1553,135,119697,1418,1332747,2519813,1452444
Naushero Feroze,1337,1314,256,238654,1058,956352,1720942,1195006
Shaheed Benazirabad,1193,1174,173,185758,1001,991793,1719019,1177551
Sukkur,1137,1136,243,224786,893,789881,1228126,1014667
Ghotki,706,706,128,141590,578,546563,1783702,688153
Mirpurkhas,896,881,219,203594,662,612970,1571142,816564
Sanghar,1119,1107,291,298269,816,803023,2155419,1101292
Tharparkar,637,635,0,0,635,685675,1649661,685675
Umerkot,523,521,175,199547,346,396565,1155714,596112
Badin,1065,1039,188,176009,851,803063,1908804,979072
Dadu,1112,1106,264,224599,842,750052,1644804,974651
Hyderabad,1050,1021,674,736490,347,375758,2621931,1112248
Sujawal,204,203,23,22774,180,176038,836941,198812
Jamshoro,482,474,106,111429,368,365718,1075807,477147
Tando Allahyar,529,526,4,3812,522,526814,614050,530626
Thatta,378,376,118,118321,258,242007,763756,360328
Matiari,447,443,109,120889,334,327321,830981,448210
Tando Muhammad Khan,404,402,21,20278,381,381734,508698,402012
Karachi West,679,668,480,544975,188,217813,3450458,762788
Karachi East,253,248,242,260339,6,6797,2002805,267136
Korangi,456,453,453,485154,0,0,2530224,485154
Karachi Central,465,457,400,436618,57,62161,2986773,498779
Karachi South,221,217,205,229249,12,13173,1816951,242422
Malir,682,663,207,220709,456,444401,1758965,665110
Jacobabad,605,599,175,138748,424,305721,925265,444469
Larkana,982,979,222,199498,757,608178,1593295,807676
Shikarpur,799,794,290,239950,504,453884,1368518,693834
Kamber,822,663,240,224500,423,396958,1438417,621458
Kashmore,496,473,184,162467,288,240424,852622,402891
Khairpur,1584,1560,135,119927,1425,1338081,2519813,1458008
Naushero Feroze,1335,1297,251,234386,1046,946001,1720942,1180387
Shaheed Benazirabad,1192,1182,174,186671,1008,997449,1719019,1184120
Sukkur,1136,1134,241,222962,893,789672,1228126,1012634
Ghotki,705,704,128,142174,576,544592,1783702,686766
Mirpurkhas,896,882,220,204660,662,613844,1571142,818504
Sanghar,1116,1106,290,296594,816,803404,2155419,1099998
Tharparkar,636,607,0,0,607,657055,1649661,657055
Umerkot,523,521,175,199612,346,396277,1155714,595889
Badin,1065,1044,190,177487,854,806665,1908804,984152
Dadu,1111,1107,266,226097,841,749410,1644804,975507
Hyderabad,1047,1038,690,753120,348,377816,2621931,1130936
Sujawal,204,203,23,22629,180,177176,836941,199805
Jamshoro,480,471,104,109588,367,365665,1075807,475253
Tando Allahyar,529,526,4,3725,522,526734,614050,530459
Thatta,378,378,119,119102,259,244104,763756,363206
Matiari,446,443,108,120610,335,329483,830981,450093
Tando Muhammad Khan,403,402,21,20259,381,381919,508698,402178
Karachi West,678,672,480,544836,192,221859,3450458,766695
Karachi East,252,248,242,260369,6,6766,2002805,267135
Korangi,454,451,451,483312,0,0,2530224,483312
Karachi Central,464,456,399,435236,57,62136,2986773,497372
Karachi South,221,214,203,227692,11,12154,1816951,239846
Malir,681,662,206,219801,456,444598,1758965,664399
Jacobabad,605,594,176,139574,418,300929,925265,440503
Larkana,981,979,222,200179,757,609353,1593295,809532
Shikarpur,799,793,290,239821,503,453744,1368518,693565
Kamber,821,766,270,251057,496,471836,1438417,722893
Kashmore,496,466,185,163467,281,233591,852622,397058
Khairpur,1583,1530,132,117167,1398,1311071,2519813,1428238
Naushero Feroze,1335,1287,244,228381,1043,945041,1720942,1173422
Shaheed Benazirabad,1190,1186,178,191834,1008,998840,1719019,1190674
Sukkur,1137,1120,228,210752,892,787209,1228126,997961
Ghotki,704,704,128,141868,576,544639,1783702,686507
Mirpurkhas,893,881,216,201128,665,617955,1571142,819083
Sanghar,1114,1102,289,295655,813,800097,2155419,1095752
Tharparkar,635,633,0,0,633,684436,1649661,684436
Umerkot,521,519,174,197906,345,394317,1155714,592223
Badin,1065,1048,190,178408,858,811341,1908804,989749
Dadu,1110,1104,264,224554,840,748673,1644804,973227
Hyderabad,1047,1031,683,746388,348,377787,2621931,1124175
Sujawal,204,203,23,22355,180,176881,836941,199236
Jamshoro,480,467,101,106284,366,364797,1075807,471081
Tando Allahyar,529,523,4,3658,519,524280,614050,527938
Thatta,378,378,119,119137,259,244061,763756,363198
Matiari,446,444,109,121588,335,330914,830981,452502
Tando Muhammad Khan,402,402,21,20284,381,382721,508698,403005
Karachi West,678,673,480,545865,193,222548,3450458,768413
Karachi East,252,247,242,260599,5,5666,2002805,266265
Korangi,453,450,450,482377,0,0,2530224,482377
Karachi Central,463,457,400,436361,57,62024,2986773,498385
Karachi South,221,214,203,225397,11,11725,1816951,237122
Malir,681,654,199,213269,455,444424,1758965,657693
Jacobabad,604,590,175,138731,415,299832,925265,438563
Larkana,981,979,222,200117,757,608604,1593295,808721
Shikarpur,799,772,290,239812,482,436887,1368518,676699
Kamber,818,718,258,242523,460,456618,1438417,699141
Kashmore,496,468,188,166121,279,232840,852622,398961
Khairpur,1581,1522,127,113569,1395,1314745,2519813,1428314
Naushero Feroze,1334,1313,257,240621,1056,956514,1720942,1197135
Shaheed Benazirabad,1190,1189,178,192263,1011,1001380,1719019,1193643
Sukkur,1137,1127,241,222486,886,782427,1228126,1004913
Ghotki,704,703,128,141821,575,544228,1783702,686049
Mirpurkhas,893,887,219,204351,668,621963,1571142,826314
Sanghar,1113,1102,288,293940,814,802710,2155419,1096650
Tharparkar,635,632,0,0,632,683340,1649661,683340
Umerkot,520,518,173,195822,345,391669,1155714,587491
Badin,1065,1046,190,178350,856,810013,1908804,988363
Dadu,1108,1106,264,223772,842,750949,1644804,974721
Hyderabad,1046,1030,687,751285,343,373510,2621931,1124795
Sujawal,204,204,23,22511,181,177496,836941,200007
Jamshoro,479,465,99,104410,366,365439,1075807,469849
Tando Allahyar,529,527,4,3665,523,527404,614050,531069
Thatta,378,378,119,118318,259,243792,763756,362110
Matiari,446,440,107,119023,333,326447,830981,445470
Tando Muhammad Khan,402,402,21,20285,381,383013,508698,403298
Karachi West,678,673,480,544738,193,222583,3450458,767321
Karachi East,251,242,237,255054,5,5666,2002805,260720
Korangi,452,450,450,482160,0,0,2530224,482160
Karachi Central,463,456,399,434407,57,61941,2986773,496348
Karachi South,221,215,204,226959,11,11937,1816951,238896
Malir,681,652,196,209978,456,446348,1758965,656326
Jacobabad,603,591,175,139054,416,300244,925265,439298
Larkana,979,978,222,200393,756,606640,1593295,807033
Shikarpur,799,793,290,239924,503,456046,1368518,695970
Kamber,818,686,261,245448,425,400424,1438417,645872
Kashmore,496,455,178,157514,276,230634,852622,388148
Khairpur,1581,1531,128,113912,1403,1320720,2519813,1434632
Naushero Feroze,1335,1310,254,237404,1056,955544,1720942,1192948
Shaheed Benazirabad,1190,1189,178,192196,1011,999901,1719019,1192097
Sukkur,1133,1117,241,222486,876,773837,1228126,996323
Ghotki,704,700,127,141021,573,543735,1783702,684756
Mirpurkhas,893,886,219,204445,667,621366,1571142,825811
Sanghar,1112,1103,290,296805,813,801621,2155419,1098426
Tharparkar,635,631,0,0,631,684317,1649661,684317
Umerkot,521,520,173,193791,347,388584,1155714,582375
Badin,1064,1048,190,178292,858,813028,1908804,991320
Dadu,1108,1108,264,225040,844,752405,1644804,977445
Hyderabad,1042,1026,682,744933,344,374955,2621931,1119888
Sujawal,204,202,23,22533,179,176062,836941,198595
Jamshoro,469,468,102,107367,366,365654,1075807,473021
Tando Allahyar,529,521,4,3680,517,522373,614050,526053
Thatta,377,377,119,119060,258,242870,763756,361930
Matiari,445,437,106,118211,331,324660,830981,442871
Tando Muhammad Khan,402,402,21,20264,381,382904,508698,403168
Karachi West,676,670,478,543104,192,221595,3450458,764699
Karachi East,249,245,240,258083,5,5667,2002805,263750
Korangi,452,449,449,481522,0,0,2530224,481522
Karachi Central,462,459,402,436664,57,61569,2986773,498233
Karachi South,221,214,203,226636,11,11979,1816951,238615
Malir,681,656,200,214065,456,446777,1758965,660842
Jacobabad,603,590,175,139043,415,299219,925265,438262
Larkana,977,977,222,200131,755,607865,1593295,807996
Shikarpur,799,793,290,240019,503,455830,1368518,695849
Kamber,818,705,271,256202,434,403914,1438417,660116
Kashmore,496,496,193,170334,302,250907,852622,421241
Khairpur,1581,1553,134,119340,1419,1332802,2519813,1452142
Naushero Feroze,1334,1310,256,239655,1054,954574,1720942,1194229
Shaheed Benazirabad,1190,1189,178,192019,1011,1002042,1719019,1194061
Sukkur,1133,1116,241,222486,875,773100,1228126,995586
Ghotki,704,700,128,142567,572,542627,1783702,685194
Mirpurkhas,891,881,218,203838,663,618705,1571142,822543
Sanghar,1112,1098,288,294253,810,799085,2155419,1093338
Tharparkar,635,630,0,0,630,683494,1649661,683494
Umerkot,521,521,173,194494,348,389041,1155714,583535
Badin,1064,1048,190,178292,858,813028,1908804,991320
Dadu,1108,1108,264,225040,844,752405,1644804,977445
Hyderabad,1042,1026,682,744933,344,374955,2621931,1119888
Sujawal,204,202,23,22533,179,176062,836941,198595
Jamshoro,469,468,102,107367,366,365654,1075807,473021
Tando Allahyar,529,521,4,3680,517,522373,614050,526053
Thatta,377,377,119,119060,258,242870,763756,361930
Matiari,445,437,106,118211,331,324660,830981,442871
Tando Muhammad Khan,402,402,21,20264,381,382904,508698,403168
Karachi West,676,670,478,543104,192,221595,3450458,764699
Karachi East,249,245,240,258083,5,5667,2002805,263750
Korangi,452,449,449,481522,0,0,2530224,481522
Karachi Central,462,459,402,436664,57,61569,2986773,498233
Karachi South,221,214,203,226636,11,11979,1816951,238615
Malir,681,656,200,214065,456,446777,1758965,660842
Jacobabad,603,590,175,139043,415,299219,925265,438262
Larkana,977,977,222,200131,755,607865,1593295,807996
Shikarpur,799,793,290,240019,503,455830,1368518,695849
Kamber,818,705,271,256202,434,403914,1438417,660116
Kashmore,496,496,193,170334,302,250907,852622,421241
Khairpur,1581,1553,134,119340,1419,1332802,2519813,1452142
Naushero Feroze,1334,1310,256,239655,1054,954574,1720942,1194229
Shaheed Benazirabad,1190,1189,178,192019,1011,1002042,1719019,1194061
Sukkur,1133,1116,241,222486,875,773100,1228126,995586
Ghotki,704,700,128,142567,572,542627,1783702,685194
Mirpurkhas,891,881,218,203838,663,618705,1571142,822543
Sanghar,1112,1098,288,294253,810,799085,2155419,1093338
Tharparkar,635,630,0,0,630,683494,1649661,683494
Umerkot,521,521,173,194494,348,389041,1155714,583535
Badin,1063,1050,190,178995,860,815620,1908804,994615
Dadu,1108,1104,264,225118,840,751827,1644804,976945
Hyderabad,1041,1027,683,754989,344,374471,2621931,1129460
Sujawal,204,204,23,22624,181,178337,836941,200961
Jamshoro,469,467,102,107951,365,364677,1075807,472628
Tando Allahyar,526,523,4,3691,519,525526,614050,529217
Thatta,375,375,118,118640,257,241824,763756,360464
Matiari,443,408,106,119227,302,294505,830981,413732
Tando Muhammad Khan,402,402,21,20413,381,383590,508698,404003
Karachi West,665,629,444,511329,185,213468,3450458,724797
Karachi East,244,242,237,253993,5,5669,2002805,259662
Korangi,453,452,451,482887,0,0,2530224,482887
Karachi Central,459,440,384,416231,56,60560,2986773,476791
Karachi South,217,213,202,223839,11,11926,1816951,235765
Malir,664,655,201,215894,452,443835,1758965,659729
Jacobabad,602,576,170,134972,406,291860,925265,426832
Larkana,977,979,222,200058,757,607687,1593295,807745
Shikarpur,794,779,287,238194,492,452325,1368518,690519
Kamber,822,690,247,232795,443,421548,1438417,654343
Kashmore,496,483,188,166192,294,244389,852622,410581
Khairpur,1581,1497,122,107246,1375,1294224,2519813,1401470
Naushero Feroze,1332,1302,255,237062,1046,948751,1720942,1185813
Shaheed Benazirabad,1189,1189,175,188530,1013,1006050,1719019,1194580
Sukkur,1132,1124,236,210659,888,762008,1228126,972667
Ghotki,704,702,128,143005,574,544241,1783702,687246
Mirpurkhas,891,884,218,203586,666,623245,1571142,826831
Sanghar,1111,1094,288,292017,806,789482,2155419,1081499
Tharparkar,634,634,0,0,634,688155,1649661,688155
Umerkot,521,520,172,194579,348,389580,1155714,584159
Badin,1060,1043,190,178946,853,811523,1908804,990469
Dadu,1108,1106,264,225242,842,754714,1644804,979956
Hyderabad,1040,1016,674,738300,342,371713,2621931,1110013
Sujawal,203,203,23,22754,180,177352,836941,200106
Jamshoro,467,467,102,107862,365,364596,1075807,472458
Tando Allahyar,525,522,4,3720,518,525250,614050,528970
Thatta,375,375,118,118905,257,241961,763756,360866
Matiari,442,406,104,116686,302,295616,830981,412302
Tando Muhammad Khan,402,397,21,20458,376,379198,508698,399656
Karachi West,663,614,439,505462,175,202222,3450458,707684
Karachi East,244,241,236,254926,5,5721,2002805,260647
Korangi,452,450,449,481920,0,0,2530224,481920
Karachi Central,459,449,393,426043,56,60038,2986773,486081
Karachi South,217,212,201,222078,11,11905,1816951,233983
Malir,658,644,189,202579,453,445733,1758965,648312
Jacobabad,600,548,170,135743,378,270732,925265,406475
Larkana,977,977,221,198987,756,607329,1593295,806316
Shikarpur,793,779,287,238908,492,451470,1368518,690378
Kamber,822,782,277,261505,505,479470,1438417,740975
Kashmore,496,496,193,170151,302,250942,852622,421093
Khairpur,1580,1545,132,116508,1413,1327075,2519813,1443583
Naushero Feroze,1327,1309,257,238837,1052,954723,1720942,1193560
Shaheed Benazirabad,1189,1190,176,189638,1013,1006381,1719019,1196019
Sukkur,1132,1123,236,213039,887,753762,1228126,966801
Ghotki,703,703,128,143428,575,546451,1783702,689879
Mirpurkhas,890,879,218,203401,661,618825,1571142,822226
Sanghar,1109,1105,290,294474,815,798420,2155419,1092894
Tharparkar,634,629,0,0,629,684701,1649661,684701
Umerkot,521,519,173,195181,346,387896,1155714,583077
Badin,1056,1044,190,178578,854,814426,1908804,993004
Dadu,1108,1105,263,224337,842,756016,1644804,980353
Hyderabad,1039,1031,685,749291,346,376309,2621931,1125600
Sujawal,203,202,23,22775,179,176483,836941,199258
Jamshoro,467,467,102,108522,365,365910,1075807,474432
Tando Allahyar,525,525,4,3727,521,528901,614050,532628
Thatta,375,375,118,118129,257,240253,763756,358382
Matiari,442,437,106,119246,331,325797,830981,445043
Tando Muhammad Khan,402,402,21,20535,381,384930,508698,405465
Karachi West,663,661,470,536369,191,218970,3450458,755339
Karachi East,244,238,233,251019,5,5726,2002805,256745
Korangi,452,450,449,480730,0,0,2530224,480730
Karachi Central,455,446,391,422528,55,59001,2986773,481529
Karachi South,217,213,202,223335,11,11906,1816951,235241
Malir,658,655,199,213809,454,444915,1758965,658724
Jacobabad,600,576,171,136474,405,290399,925265,426873
Larkana,977,972,221,198449,751,604190,1593295,802639
Shikarpur,788,774,286,238419,488,449130,1368518,687549
Kamber,822,793,289,271268,504,469730,1438417,740998
Kashmore,496,488,193,170151,294,244187,852622,414338
Khairpur,1576,1544,128,113115,1416,1330254,2519813,1443369
Naushero Feroze,1319,1302,255,237063,1047,951152,1720942,1188215
Shaheed Benazirabad,1189,1190,176,189672,1013,1007294,1719019,1196966
Sukkur,1131,1115,228,202195,887,742890,1228126,945085
Ghotki,703,703,128,143113,575,548499,1783702,691612
Mirpurkhas,888,880,218,205263,662,620452,1571142,825715
Sanghar,1108,1106,290,294403,816,800796,2155419,1095199
Tharparkar,634,623,0,0,623,679003,1649661,679003
Umerkot,521,521,174,196445,347,388102,1155714,584547
Badin,1056,1039,189,178286,850,812978,1908804,991264
Dadu,1106,1099,261,222966,838,752398,1644804,975364
Hyderabad,1039,1036,690,754642,346,377353,2621931,1131995
Sujawal,203,203,23,22623,180,177614,836941,200237
Jamshoro,467,466,102,108176,364,365391,1075807,473567
Tando Allahyar,525,521,4,3724,517,526571,614050,530295
Thatta,375,375,118,118251,257,240140,763756,358391
Matiari,442,438,105,118506,333,328983,830981,447489
Tando Muhammad Khan,402,399,21,20516,378,381982,508698,402498
Karachi West,661,659,468,532017,191,218934,3450458,750951
Karachi East,243,238,234,251680,4,4447,2002805,256127
Korangi,452,447,446,482008,0,0,2530224,482008
Karachi Central,454,442,387,417864,55,58930,2986773,476794
Karachi South,217,212,201,221036,11,11920,1816951,232956
Malir,658,652,196,210860,454,443849,1758965,654709
Jacobabad,600,559,158,125361,401,287636,925265,412997
Larkana,977,972,219,197404,753,607003,1593295,804407
Shikarpur,788,786,286,237975,500,459073,1368518,697048
Kamber,821,799,287,269180,512,476195,1438417,745375
Kashmore,496,478,192,169359,285,236156,852622,405515
Khairpur,1576,1507,130,115588,1377,1290004,2519813,1405592
Naushero Feroze,1319,1299,252,236033,1047,953330,1720942,1189363
Shaheed Benazirabad,1188,1188,176,189610,1011,1006931,1719019,1196541
Sukkur,1128,1095,235,207275,860,722036,1228126,929311
Ghotki,703,703,128,142620,575,548928,1783702,691548
Mirpurkhas,887,875,215,202521,660,619340,1571142,821861
Sanghar,1107,1103,290,294602,813,800202,2155419,1094804
Tharparkar,634,632,0,0,632,690000,1649661,690000
Umerkot,521,522,174,196583,348,389584,1155714,586167
Badin,1055,1042,190,180390,852,816464,1908804,996854
Dadu,1105,1100,261,222142,839,753268,1644804,975410
Hyderabad,1036,1033,688,752714,345,377358,2621931,1130072
Sujawal,203,203,23,22670,180,176916,836941,199586
Jamshoro,466,461,99,104374,362,362131,1075807,466505
Tando Allahyar,525,520,4,3714,516,525467,614050,529181
Thatta,375,375,118,118206,257,240700,763756,358906
Matiari,442,434,105,118576,329,325206,830981,443782
Tando Muhammad Khan,401,393,21,20508,372,376554,508698,397062
Karachi West,661,656,466,528829,190,216863,3450458,745692
Karachi East,243,241,236,254808,5,5545,2002805,260353
Korangi,450,448,447,487229,0,0,2530224,487229
Karachi Central,453,431,377,408512,54,57251,2986773,465763
Karachi South,217,214,203,223231,11,11923,1816951,235154
Malir,656,651,198,212916,451,439688,1758965,652604
Jacobabad,600,557,157,124624,400,288417,925265,413041
Larkana,977,961,219,198411,742,597798,1593295,796209
Shikarpur,788,764,271,224505,493,453995,1368518,678500
Kamber,821,763,282,265665,481,447140,1438417,712805
Kashmore,496,478,192,169351,285,236292,852622,405643
Khairpur,1576,1529,129,114698,1400,1316129,2519813,1430827
Naushero Feroze,1317,1297,255,238808,1042,950441,1720942,1189249
Shaheed Benazirabad,1187,1188,175,190254,1012,1007282,1719019,1197536
Sukkur,1126,1050,174,154815,876,734368,1228126,889183
Ghotki,703,700,128,141096,572,548091,1783702,689187
Mirpurkhas,888,880,217,203315,663,621517,1571142,824832
Sanghar,1107,1105,290,295024,815,802379,2155419,1097403
Tharparkar,634,631,0,0,631,690404,1649661,690404
Umerkot,520,520,173,195573,347,388411,1155714,583984
Badin,1089,1058,191,176002,867,796622,1908804,972624
Dadu,1130,1119,271,229390,848,743472,1644804,972862
Hyderabad,1079,1048,707,759380,341,362517,2621931,1121897
Sujawal,205,205,24,24007,181,174536,836941,198543
Jamshoro,478,472,109,113609,363,355123,1075807,468732
Tando Allahyar,533,530,0,0,530,537620,614050,537620
Thatta,380,375,119,118191,256,237787,763756,355978
Matiari,452,451,110,121863,341,332150,830981,454013
Tando Muhammad Khan,407,397,21,19013,376,360368,508698,379381
Karachi West,721,692,498,563498,194,222106,3450458,785604
Karachi East,258,249,241,259776,8,8811,2002805,268587
Korangi,481,462,461,487801,1,1020,2530224,488821
Karachi Central,491,464,405,440480,59,63365,2986773,503845
Karachi South,240,225,215,239579,10,10741,1816951,250320
Malir,693,666,207,216065,459,437587,1758965,653652
Jacobabad,608,606,176,141985,430,312475,925265,454460
Larkana,996,987,226,200808,761,606745,1593295,807553
Shikarpur,815,784,270,220068,514,453648,1368518,673716
Kamber,833,788,294,270040,494,445954,1438417,715994
Kashmore,508,333,145,128210,188,156859,852622,285069
Khairpur,1596,1586,136,117315,1450,1337951,2519813,1455266
Naushero Feroze,1355,1325,257,235752,1068,965164,1720942,1200916
Shaheed Benazirabad,1206,1194,181,192312,1013,976602,1719019,1168914
Sukkur,1143,1138,244,229669,894,808238,1228126,1037907
Ghotki,710,706,126,137545,580,541920,1783702,679465
Mirpurkhas,908,882,217,200461,665,607754,1571142,808215
Sanghar,1139,1123,291,299634,832,829271,2155419,1128905
Tharparkar,638,631,0,0,631,667809,1649661,667809
Umerkot,526,526,176,191804,350,383173,1155714,574977
Badin,1088,1056,190,174961,866,796436,1908804,971397
Dadu,1127,1116,272,230480,844,740977,1644804,971457
Hyderabad,1078,1032,688,743894,344,367232,2621931,1111126
Sujawal,205,205,24,24067,181,175582,836941,199649
Jamshoro,480,470,108,113068,362,355224,1075807,468292
Tando Allahyar,533,527,0,0,527,533737,614050,533737
Thatta,380,375,119,118330,256,237174,763756,355504
Matiari,452,449,109,120575,340,332409,830981,452984
Tando Muhammad Khan,407,397,21,19018,376,359021,508698,378039
Karachi West,718,692,495,560767,197,225537,3450458,786304
Karachi East,258,246,238,256561,8,8762,2002805,265323
Korangi,480,467,466,494574,1,1020,2530224,495594
Karachi Central,489,460,401,436359,59,63427,2986773,499786
Karachi South,240,222,214,239326,8,8496,1816951,247822
Malir,689,660,204,212307,456,436767,1758965,649074
Jacobabad,608,605,176,141323,429,310718,925265,452041
Larkana,996,983,226,201787,757,601985,1593295,803772
Shikarpur,814,804,292,238115,512,453620,1368518,691735
Kamber,833,791,293,268022,498,451123,1438417,719145
Kashmore,508,283,110,97118,173,143774,852622,240892
Khairpur,1595,1583,139,120093,1444,1331243,2519813,1451336
Naushero Feroze,1351,1311,253,240779,1058,948831,1720942,1189610
Shaheed Benazirabad,1205,1194,181,192008,1013,991453,1719019,1183461
Sukkur,1143,1139,243,228720,896,808882,1228126,1037602
Ghotki,711,708,128,139352,580,541498,1783702,680850
Mirpurkhas,908,886,220,202227,666,609980,1571142,812207
Sanghar,1134,1119,291,300211,828,823967,2155419,1124178
Tharparkar,637,634,0,0,634,671697,1649661,671697
Umerkot,525,523,174,190698,349,381173,1155714,571871
Badin,1085,1039,190,175090,849,783836,1908804,958926
Dadu,1120,1115,271,229891,844,741269,1644804,971160
Hyderabad,1073,1033,694,751134,339,363866,2621931,1115000
Sujawal,205,205,24,23685,181,175875,836941,199560
Jamshoro,480,474,110,114936,364,357625,1075807,472561
Tando Allahyar,533,528,0,0,528,532491,614050,532491
Thatta,380,377,120,119701,257,237633,763756,357334
Matiari,450,446,109,120192,337,327963,830981,448155
Tando Muhammad Khan,406,397,21,19221,376,358589,508698,377810
Karachi West,712,690,497,563074,193,222752,3450458,785826
Karachi East,258,250,241,259888,9,9817,2002805,269705
Korangi,480,464,463,492298,1,1018,2530224,493316
Karachi Central,486,462,404,439569,58,62637,2986773,502206
Karachi South,238,222,212,236179,10,10916,1816951,247095
Malir,688,663,204,213061,459,439298,1758965,652359
Jacobabad,607,605,175,140762,430,311318,925265,452080
Larkana,995,985,221,197116,764,607128,1593295,804244
Shikarpur,814,764,274,226081,490,440117,1368518,666198
Kamber,832,788,286,262399,502,454461,1438417,716860
Kashmore,507,412,147,129986,265,220101,852622,350087
Khairpur,1595,1577,137,118302,1440,1325673,2519813,1443975
Naushero Feroze,1349,1305,246,227876,1059,948885,1720942,1176761
Shaheed Benazirabad,1206,1195,181,192261,1014,998083,1719019,1190344
Sukkur,1142,1139,242,227811,897,809983,1228126,1037794
Ghotki,711,708,128,139601,580,540821,1783702,680422
Mirpurkhas,905,872,216,198728,656,600465,1571142,799193
Sanghar,1132,1115,291,299130,824,819816,2155419,1118946
Tharparkar,637,635,0,0,635,674632,1649661,674632
Umerkot,524,520,173,189342,347,379298,1155714,568640
Badin,1084,1040,190,175688,850,783933,1908804,959621
Dadu,1120,1112,271,230054,841,739283,1644804,969337
Hyderabad,1069,1038,692,751085,346,371220,2621931,1122305
Sujawal,205,205,24,23564,181,175881,836941,199445
Jamshoro,481,472,109,113564,363,356752,1075807,470316
Tando Allahyar,534,525,0,0,525,529185,614050,529185
Thatta,380,375,120,119810,255,236145,763756,355955
Matiari,450,449,111,122695,338,329369,830981,452064
Tando Muhammad Khan,406,397,20,18639,377,361151,508698,379790
Karachi West,701,672,478,540497,194,224278,3450458,764775
Karachi East,258,250,241,260351,9,9963,2002805,270314
Korangi,479,463,463,493307,0,0,2530224,493307
Karachi Central,484,459,400,435292,59,63457,2986773,498749
Karachi South,229,221,212,236162,9,9740,1816951,245902
Malir,686,664,203,211918,461,442637,1758965,654555
Jacobabad,606,603,175,140657,428,308074,925265,448731
Larkana,995,989,226,201455,763,608357,1593295,809812
Shikarpur,814,779,274,226305,505,457044,1368518,683349
Kamber,829,761,269,245118,492,446702,1438417,691820
Kashmore,507,488,192,169426,296,244674,852622,414100
Khairpur,1594,1578,138,119202,1440,1325706,2519813,1444908
Naushero Feroze,1349,1320,257,236995,1063,953116,1720942,1190111
Shaheed Benazirabad,1202,1190,180,191501,1010,987313,1719019,1178814
Sukkur,1146,1140,244,229975,896,808608,1228126,1038583
Ghotki,711,707,128,139602,579,540148,1783702,679750
Mirpurkhas,905,868,215,197961,653,599420,1571142,797381
Sanghar,1132,1112,293,299609,819,812650,2155419,1112259
Tharparkar,637,633,0,0,633,675648,1649661,675648
Umerkot,522,520,173,189431,347,379872,1155714,569303
Badin,1084,997,190,175887,807,743641,1908804,919528
Dadu,1120,1110,268,227170,842,740552,1644804,967722
Hyderabad,1065,1030,691,749508,339,364070,2621931,1113578
Sujawal,205,204,24,23722,180,175021,836941,198743
Jamshoro,481,466,100,104729,366,361139,1075807,465868
Tando Allahyar,534,524,0,0,524,528643,614050,528643
Thatta,380,375,119,119174,256,237810,763756,356984
Matiari,450,441,111,122891,330,320905,830981,443796
Tando Muhammad Khan,406,399,21,19278,378,362743,508698,382021
Karachi West,698,681,491,557728,190,220689,3450458,778417
Karachi East,257,245,237,256638,8,8958,2002805,265596
Korangi,478,463,463,493359,0,0,2530224,493359
Karachi Central,482,462,405,441133,57,61671,2986773,502804
Karachi South,227,218,210,232771,8,8868,1816951,241639
Malir,686,659,204,214832,455,438028,1758965,652860
Jacobabad,606,603,175,140499,428,309392,925265,449891
Larkana,995,991,226,201531,765,610114,1593295,811645
Shikarpur,813,772,273,225238,499,451937,1368518,677175
Kamber,828,775,280,256264,495,450632,1438417,706896
Kashmore,507,382,142,125602,240,198673,852622,324275
Khairpur,1595,1571,138,119804,1433,1319327,2519813,1439131
Naushero Feroze,1348,1328,260,241296,1068,960800,1720942,1202096
Shaheed Benazirabad,1202,1189,180,191521,1009,989994,1719019,1181515
Sukkur,1142,1140,244,229645,896,808909,1228126,1038554
Ghotki,711,707,128,138922,579,540083,1783702,679005
Mirpurkhas,906,883,215,198337,668,613423,1571142,811760
Sanghar,1132,1116,291,299245,825,816335,2155419,1115580
Tharparkar,637,629,0,0,629,671657,1649661,671657
Umerkot,522,522,174,191112,348,382238,1155714,573350
Badin,1082,1039,190,175840,849,785110,1908804,960950
Dadu,1119,1112,269,228121,843,741007,1644804,969128
Hyderabad,1066,1030,687,746110,343,369285,2621931,1115395
Sujawal,205,205,24,23501,181,176196,836941,199697
Jamshoro,481,469,107,111781,362,357949,1075807,469730
Tando Allahyar,534,523,0,0,523,528016,614050,528016
Thatta,380,374,119,119257,255,236827,763756,356084
Matiari,449,441,109,120707,332,324104,830981,444811
Tando Muhammad Khan,406,393,21,19286,372,358614,508698,377900
Karachi West,698,686,491,558451,195,225945,3450458,784396
Karachi East,257,251,243,261850,8,8972,2002805,270822
Korangi,478,463,463,503720,0,0,2530224,503720
Karachi Central,482,464,405,441379,59,63942,2986773,505321
Karachi South,223,219,207,230532,12,13452,1816951,243984
Malir,685,632,173,180557,459,443139,1758965,623696
Jacobabad,606,604,175,140505,429,309018,925265,449523
Larkana,994,986,225,200762,761,608411,1593295,809173
Shikarpur,811,792,288,237813,504,455653,1368518,693466
Kamber,827,775,279,253799,496,452015,1438417,705814
Kashmore,507,490,194,171147,296,244940,852622,416087
Khairpur,1593,1572,138,119591,1434,1321870,2519813,1441461
Naushero Feroze,1348,1286,257,237388,1029,922809,1720942,1160197
Shaheed Benazirabad,1201,1191,180,191633,1011,993446,1719019,1185079
Sukkur,1142,1140,244,229616,896,809220,1228126,1038836
Ghotki,710,705,128,139104,577,539371,1783702,678475
Mirpurkhas,905,864,216,198887,648,596535,1571142,795422
Sanghar,1130,1114,292,299788,822,813323,2155419,1113111
Tharparkar,637,628,0,0,628,669588,1649661,669588
Umerkot,522,521,173,189687,348,381763,1155714,571450
Badin,1080,980,187,173290,793,734084,1908804,907374
Dadu,1117,1112,269,228632,843,741861,1644804,970493
Hyderabad,1065,1026,688,748003,338,364217,2621931,1112220
Sujawal,205,205,24,23498,181,176112,836941,199610
Jamshoro,479,476,112,117025,364,359988,1075807,477013
Tando Allahyar,533,524,0,0,524,528485,614050,528485
Thatta,379,372,119,119251,253,236086,763756,355337
Matiari,449,444,110,121550,334,325351,830981,446901
Tando Muhammad Khan,406,392,21,19509,371,358375,508698,377884
Karachi West,695,688,493,560540,195,225916,3450458,786456
Karachi East,256,189,185,201607,4,4759,2002805,206366
Korangi,477,453,453,483863,0,0,2530224,483863
Karachi Central,479,444,386,422075,58,62367,2986773,484442
Karachi South,223,201,190,211356,11,12317,1816951,223673
Malir,684,663,206,217453,457,442052,1758965,659505
Jacobabad,606,603,175,138781,428,306534,925265,445315
Larkana,993,984,225,200977,759,609398,1593295,810375
Shikarpur,811,782,279,229921,503,454197,1368518,684118
Kamber,825,668,258,235010,410,378704,1438417,613714
Kashmore,507,491,197,173970,294,242795,852622,416765
Khairpur,1592,1567,136,118828,1431,1320930,2519813,1439758
Naushero Feroze,1347,1315,258,239134,1057,948225,1720942,1187359
Shaheed Benazirabad,1199,1188,179,190570,1009,1000586,1719019,1191156
Sukkur,1141,1137,244,229616,893,806860,1228126,1036476
Ghotki,710,707,128,139133,579,541813,1783702,680946
Mirpurkhas,903,862,213,196467,649,597267,1571142,793734
Sanghar,1128,1111,291,298136,820,811324,2155419,1109460
Tharparkar,637,608,0,0,608,650122,1649661,650122
Umerkot,522,521,173,189451,348,382183,1155714,571634
Badin,1080,1013,190,176348,823,761343,1908804,937691
Dadu,1115,1110,267,226336,843,743542,1644804,969878
Hyderabad,1061,1024,683,745913,341,368295,2621931,1114208
Sujawal,205,205,24,23498,181,176112,836941,199610
Jamshoro,479,464,100,104833,364,360494,1075807,465327
Tando Allahyar,533,518,0,0,518,522250,614050,522250
Thatta,378,372,119,119350,253,236035,763756,355385
Matiari,449,436,110,121510,326,316484,830981,437994
Tando Muhammad Khan,406,399,21,19385,378,365308,508698,384693
Karachi West,693,684,490,556724,194,224598,3450458,781322
Karachi East,256,234,229,246678,5,5583,2002805,252261
Korangi,477,441,441,471293,0,0,2530224,471293
Karachi Central,478,464,406,442274,58,62630,2986773,504904
Karachi South,223,215,207,230329,8,8709,1816951,239038
Malir,683,662,205,217303,457,441198,1758965,658501
Jacobabad,606,600,174,137668,426,306352,925265,444020
Larkana,993,983,225,200857,758,609216,1593295,810073
Shikarpur,810,784,291,240381,493,444351,1368518,684732
Kamber,825,710,273,248760,437,402787,1438417,651547
Kashmore,507,487,194,170973,293,241780,852622,412753
Khairpur,1593,1572,136,118463,1436,1324842,2519813,1443305
Naushero Feroze,1345,1301,258,239673,1043,933298,1720942,1172971
Shaheed Benazirabad,1199,1187,179,190126,1008,1002133,1719019,1192259
Sukkur,1140,1136,243,228692,893,804756,1228126,1033448
Ghotki,708,705,128,140067,577,546016,1783702,686083
Mirpurkhas,903,864,210,193753,654,602507,1571142,796260
Sanghar,1128,1112,291,297766,821,805566,2155419,1103332
Tharparkar,637,626,0,0,626,671015,1649661,671015
Umerkot,522,519,173,190860,346,386284,1155714,577144
Badin,1078,1036,189,175902,847,785850,1908804,961752
Dadu,1115,1108,267,226892,841,744009,1644804,970901
Hyderabad,1062,1035,693,754500,342,370285,2621931,1124785
Sujawal,205,205,24,23498,181,176523,836941,200021
Jamshoro,479,463,102,106734,361,358064,1075807,464798
Tando Allahyar,533,528,4,3348,524,536793,614050,540141
Thatta,378,374,119,120397,255,238556,763756,358953
Matiari,449,441,110,121465,331,323043,830981,444508
Tando Muhammad Khan,405,404,21,19393,383,370489,508698,389882
Karachi West,693,685,490,556316,195,225953,3450458,782269
Karachi East,256,254,246,264730,8,8796,2002805,273526
Korangi,464,450,450,480027,0,0,2530224,480027
Karachi Central,478,462,405,441812,57,61518,2986773,503330
Karachi South,223,216,205,227343,11,12243,1816951,239586
Malir,683,659,202,214357,457,442408,1758965,656765
Jacobabad,606,599,175,138715,424,305266,925265,443981
Larkana,992,982,224,200174,758,609597,1593295,809771
Shikarpur,804,745,253,209666,492,443869,1368518,653535
Kamber,825,575,202,186375,373,343909,1438417,530284
Kashmore,507,489,194,170927,295,244610,852622,415537
Khairpur,1590,1558,133,116187,1425,1326584,2519813,1442771
Naushero Feroze,1342,1313,255,237316,1058,952053,1720942,1189369
Shaheed Benazirabad,1199,1195,180,191375,1015,1035279,1719019,1226654
Sukkur,1135,1136,243,228692,893,803948,1228126,1032640
Ghotki,703,705,127,139215,578,544007,1783702,683222
Mirpurkhas,901,868,210,194950,658,607568,1571142,802518
Sanghar,1126,1112,290,297310,822,806869,2155419,1104179
Tharparkar,637,636,0,0,636,682762,1649661,682762
Umerkot,522,519,174,192966,345,387445,1155714,580411
Badin,1078,1011,186,173523,825,768427,1908804,941950
Dadu,1115,1106,267,227281,839,742286,1644804,969567
Hyderabad,1061,1023,681,742483,342,369353,2621931,1111836
Sujawal,205,205,24,23498,181,176289,836941,199787
Jamshoro,479,471,108,113073,363,359890,1075807,472963
Tando Allahyar,531,528,4,3748,524,529763,614050,533511
Thatta,378,374,118,119876,256,239766,763756,359642
Matiari,449,441,110,121625,331,324420,830981,446045
Tando Muhammad Khan,405,405,21,19736,384,375648,508698,395384
Karachi West,692,683,489,556630,194,225219,3450458,781849
Karachi East,256,227,220,238514,7,7797,2002805,246311
Korangi,461,453,453,484994,0,0,2530224,484994
Karachi Central,477,458,403,439075,55,59283,2986773,498358
Karachi South,223,182,179,199407,3,3153,1816951,202560
Malir,683,654,199,211367,455,440501,1758965,651868
Jacobabad,605,597,175,138987,422,302756,925265,441743
Larkana,992,989,224,200791,765,612836,1593295,813627
Shikarpur,804,770,274,226871,496,447376,1368518,674247
Kamber,825,612,236,216538,376,346619,1438417,563157
Kashmore,504,483,191,168162,292,242077,852622,410239
Khairpur,1588,1551,134,117566,1417,1321473,2519813,1439039
Naushero Feroze,1347,1240,229,214289,1011,913349,1720942,1127638
Shaheed Benazirabad,1200,1193,179,190806,1014,1011601,1719019,1202407
Sukkur,1135,1104,243,228692,861,774986,1228126,1003678
Ghotki,706,704,127,139848,577,542595,1783702,682443
Mirpurkhas,898,877,214,198747,663,613501,1571142,812248
Sanghar,1126,1110,291,298812,819,805921,2155419,1104733
Tharparkar,637,636,0,0,636,683479,1649661,683479
Umerkot,522,519,173,193531,346,390428,1155714,583959
Badin,1073,1031,180,168225,851,795909,1908804,964134
Dadu,1113,1109,266,227213,843,747075,1644804,974288
Hyderabad,1059,1037,691,755902,346,374987,2621931,1130889
Sujawal,205,205,24,23498,181,176289,836941,199787
Jamshoro,479,467,107,112094,360,356636,1075807,468730
Tando Allahyar,531,528,4,3756,524,530221,614050,533977
Thatta,378,378,120,121762,258,242232,763756,363994
Matiari,446,443,111,122884,332,326272,830981,449156
Tando Muhammad Khan,405,403,21,19785,382,376284,508698,396069
Karachi West,690,682,488,555853,194,225168,3450458,781021
Karachi East,255,245,237,256063,8,8792,2002805,264855
Korangi,461,455,455,487164,0,0,2530224,487164
Karachi Central,474,460,402,437200,58,62827,2986773,500027
Karachi South,222,214,204,226916,10,11248,1816951,238164
Malir,682,630,182,193977,448,434595,1758965,628572
Jacobabad,605,597,175,138912,422,302266,925265,441178
Larkana,988,982,222,199595,760,610672,1593295,810267
Shikarpur,803,750,282,233784,468,422243,1368518,656027
Kamber,825,616,221,206026,395,365710,1438417,571736
Kashmore,504,467,186,164146,281,234486,852622,398632
Khairpur,1591,1570,134,118522,1436,1344384,2519813,1462906
Naushero Feroze,1346,1301,255,246654,1046,945348,1720942,1192002
Shaheed Benazirabad,1198,1190,175,187154,1015,1020718,1719019,1207872
Sukkur,1139,1096,242,224839,854,764503,1228126,989342
Ghotki,706,705,127,140298,578,545282,1783702,685580
Mirpurkhas,897,868,216,200602,652,604273,1571142,804875
Sanghar,1122,1093,282,290987,811,798865,2155419,1089852
Tharparkar,637,637,0,0,637,686852,1649661,686852
Umerkot,523,516,174,195687,342,389982,1155714,585669
Badin,1072,1042,186,174479,856,811646,1908804,986125
Dadu,1111,1107,267,227986,840,745496,1644804,973482
Hyderabad,1056,1011,664,725618,347,377067,2621931,1102685
Sujawal,205,204,23,22632,181,176289,836941,198921
Jamshoro,483,474,108,113821,366,364503,1075807,478324
Tando Allahyar,531,525,4,3766,521,528267,614050,532033
Thatta,379,373,118,119897,255,239701,763756,359598
Matiari,448,445,111,122979,334,328794,830981,451773
Tando Muhammad Khan,405,403,21,19806,382,377321,508698,397127
Karachi West,690,672,478,545032,194,224795,3450458,769827
Karachi East,255,202,197,214348,5,5438,2002805,219786
Korangi,461,453,453,485926,0,0,2530224,485926
Karachi Central,470,448,392,426919,56,60824,2986773,487743
Karachi South,222,217,206,229671,11,12253,1816951,241924
Malir,682,647,201,214234,446,432026,1758965,646260
Jacobabad,605,598,174,138785,424,304683,925265,443468
Larkana,988,980,224,201184,756,606743,1593295,807927
Shikarpur,803,773,271,223600,502,452626,1368518,676226
Kamber,824,660,254,237091,406,378162,1438417,615253
Kashmore,496,459,181,159983,278,231243,852622,391226
Khairpur,1591,1570,136,120339,1434,1347942,2519813,1468281
Naushero Feroze,1343,1300,254,237112,1046,944846,1720942,1181958
Shaheed Benazirabad,1193,1184,175,188551,1009,998885,1719019,1187436
Sukkur,1139,1133,242,223820,891,788044,1228126,1011864
Ghotki,706,706,128,141448,578,545835,1783702,687283
Mirpurkhas,898,878,217,200934,661,612767,1571142,813701
Sanghar,1121,1093,279,287306,814,802828,2155419,1090134
Tharparkar,637,628,0,0,628,676915,1649661,676915
Umerkot,523,497,156,175206,341,390078,1155714,565284
